GGGGGGGGGGGGGGGGGGGG    
G                  GC   
G   F              G    
G  GGGGGGG         GB   
G                  G    
G                  GP   
G         GGGGGGG  G    
G                  GL   
G  S               G    
GGGGGGGGGGGGGGGGGGGGR  T