GGGGGGGGGGGGGGGGGGGG
G                  G
G   F              G
G  GGGGGGG         G
G                  G
G                  G
G         GGGGGGG  G
G                  G
G  S               G
GGGGGGGGGGGGGGGGGGGG