GGGGGGGGGGGGGGGGGGGG
G                  G
G                  G
G  GGGGGGG         G
G                  G
G                  G
G         GGGGGGG  G
G                  G
G                  G
GGGGGGGGGGGGGGGGGGGG